7777777777777777
0011111111111119
0010000000000000
0011111111100000
0000000000100000
0000111100100000
0000100100100000
0000100100100000
0000100111100000
8111100000000000
0000000000000000
7777777777777777
