7777777777777777
0011111111111100
0010000000000100
0011111111100100
0000000000100100
0000111100100100
0000100100100119
0000100111100000
0000111000000000
0000001000000000
8111111000000000
7777777777777777
